.........**.........
.x................x.
......********......
......********......
......********......
.x................x.
.........**.........
