.........**.........
.@................@.
......********......
......********......
......********......
.@................@.
.........**.........
